111111
1100011
100S001
1100011
111111