111111
100001
101111
100001
111111