111111
100001
100000
100001
111111