1111111111111111111111111
1000000000110000000000001
1011000011110000000000001
10010111000000S0000000001
1111111110110000011100001
1000000000110000011101111
1111011111111101110000001
1111011111111101110101001
1100000011010101110000001
1000000000000000110000001
1000000000000000110101001
1100000111010101111101111
1111011111110101110111101
1111111111111111111111111